  /$$$$$$   /$$$$$$  /$$      /$$ /$$$$$$$$        /$$$$$$  /$$    /$$ /$$$$$$$$ /$$$$$$$  /$$
 /$$__  $$ /$$__  $$| $$$    /$$$| $$_____/       /$$__  $$| $$   | $$| $$_____/| $$__  $$| $$
| $$  \__/| $$  \ $$| $$$$  /$$$$| $$            | $$  \ $$| $$   | $$| $$      | $$  \ $$| $$
| $$ /$$$$| $$$$$$$$| $$ $$/$$ $$| $$$$$         | $$  | $$|  $$ / $$/| $$$$$   | $$$$$$$/| $$
| $$|_  $$| $$__  $$| $$  $$$| $$| $$__/         | $$  | $$ \  $$ $$/ | $$__/   | $$__  $$|__/
| $$  \ $$| $$  | $$| $$\  $ | $$| $$            | $$  | $$  \  $$$/  | $$      | $$  \ $$    
|  $$$$$$/| $$  | $$| $$ \/  | $$| $$$$$$$$      |  $$$$$$/   \  $/   | $$$$$$$$| $$  | $$ /$$
 \______/ |__/  |__/|__/     |__/|________/       \______/     \_/    |________/|__/  |__/|__/                                                                                              